1111111111111
1001000000001
100P011111001
100011C00CE01
1111111111111