1111111111111
1001000000001
100P011111001
100011EC01001
1111111111111